111111
1CSE01
101101
10MM01
1P0C01
111111